40 20
128 1088
3 3 3 3 3 3 3 3 3 3 3 3 3 3 3 3 3 3 3 3 3 3 3 3 3 3 3 3 3 3 3 3 3 3 3 3 3 3 3 3
3 3 3 3 9 3 3 3 3 3 3 3 3 3 3 3 3 3 3 3 3 3 3 3 3 3 3 3 3 3 3 3 3 3 3 3 3 3 3 3
3 12 12 12 1 12 12 12 12 12 12 12 12 12 12 12 12 12 12 12 12 1 1 1 1 12 12 12 12 12 12 12 12 12 12 12 12 12 12 3
3 12 12 12 1 1 1 12 12 12 12 12 12 12 1 1 1 1 1 1 1 1 1 1 1 1 1 1 1 1 1 1 1 1 1 1 1 1 12 3
3 12 12 12 12 1 1 1 1 1 1 1 1 1 1 1 12 12 12 12 12 12 1 1 12 12 12 12 1 1 1 1 1 1 1 1 1 1 12 3
3 12 12 12 12 12 12 12 1 1 1 1 1 1 12 12 12 12 12 12 1 1 1 1 1 1 12 12 12 12 12 12 12 12 12 12 1 1 12 3
3 12 12 12 12 12 12 12 12 12 1 12 12 12 12 12 12 12 12 3 3 3 3 3 3 3 3 12 12 12 12 12 12 12 12 12 1 1 12 3
3 12 12 12 12 12 12 12 12 12 1 12 12 12 12 12 12 12 12 3 0 0 0 0 0 0 3 12 12 12 12 12 12 12 12 12 1 1 12 3
3 3 3 3 3 3 3 3 1 1 1 1 1 3 3 3 3 3 3 3 0 0 0 0 0 0 3 3 3 3 3 3 3 3 3 3 1 1 3 3
3 0 0 0 0 0 0 3 1 1 1 1 1 3 0 0 0 0 0 3 0 0 3 3 0 0 0 0 0 0 0 0 0 0 0 0 1 1 0 3
3 0 0 0 0 0 0 3 3 3 3 3 3 3 0 0 0 0 0 3 0 0 0 3 0 0 0 0 0 0 0 0 0 0 0 0 0 0 0 3
3 0 0 0 0 0 0 0 0 0 0 3 0 0 0 0 0 0 0 3 3 0 0 3 0 0 0 6 6 6 6 6 6 6 6 6 0 0 0 3
3 0 0 0 0 0 0 0 0 0 0 3 0 0 0 0 0 0 0 0 3 0 0 3 0 0 0 6 1 1 1 1 1 1 1 6 0 0 0 3
3 0 0 0 0 0 0 3 3 0 0 3 3 3 0 3 3 3 0 0 3 0 0 3 0 0 0 6 1 1 1 1 1 1 1 6 0 0 0 3
3 0 0 0 0 0 0 3 0 0 0 0 0 0 0 3 0 0 0 0 3 0 0 3 0 0 0 6 1 1 1 1 1 1 1 6 0 0 0 3
3 0 0 0 0 0 0 3 0 0 0 0 0 3 3 3 0 0 0 0 3 0 0 3 0 0 0 6 1 1 1 1 1 1 1 6 0 0 0 3
3 3 0 3 3 3 3 3 3 3 0 3 3 3 0 0 0 0 3 3 3 0 0 3 0 0 0 6 6 6 6 1 6 6 6 6 0 0 0 3
3 0 0 0 3 0 0 0 0 0 0 3 0 0 0 0 0 0 0 0 0 0 0 3 0 0 0 0 0 0 6 1 6 0 0 0 0 0 0 3
3 0 0 0 3 0 0 0 0 0 0 3 0 0 0 0 0 0 0 0 0 0 0 3 0 0 0 0 0 0 0 0 0 0 0 0 0 0 0 3
3 3 3 3 3 3 3 3 3 3 3 3 3 3 3 3 3 3 3 3 3 3 3 3 3 3 3 3 3 3 3 3 3 3 3 3 3 3 3 3