20 62
128 3840
5 5 5 5 5 5 5 5 5 5 5 5 5 5 5 5 5 5 5 5
5 5 5 5 5 5 5 5 5 5 5 5 5 5 5 5 5 5 5 5
5 5 5 2 2 2 2 2 2 2 2 2 2 2 2 2 2 5 5 5
5 5 5 2 2 2 2 2 2 2 2 2 2 2 2 2 2 5 5 5
5 5 5 2 2 2 2 2 2 2 2 2 2 2 2 2 2 5 5 5
5 5 5 2 2 2 2 2 2 2 2 2 2 2 2 2 2 5 5 5
5 5 5 2 2 2 2 2 2 2 2 2 2 2 2 2 2 5 5 5
5 5 5 2 2 2 2 2 2 2 2 2 2 2 2 2 2 5 5 5
5 5 5 2 2 2 2 2 2 2 2 2 2 2 2 2 2 5 5 5
5 5 5 2 2 2 2 2 2 2 2 2 2 2 2 2 2 5 5 5
5 5 5 2 2 2 2 2 2 2 2 2 2 2 2 2 2 5 5 5
5 5 5 5 5 5 5 5 5 2 2 5 5 5 5 5 5 5 5 5
5 5 5 5 5 5 5 5 5 2 2 5 5 5 5 5 5 5 5 5
5 5 5 5 5 5 5 5 5 2 2 5 5 5 5 5 5 5 5 5
5 5 5 5 5 5 5 5 5 2 2 5 5 5 5 5 5 5 5 5
5 5 5 5 5 5 5 5 5 2 2 5 5 5 5 5 5 5 5 5
5 5 5 5 5 5 5 5 5 2 2 5 5 5 5 5 5 5 5 5
5 5 5 5 5 5 5 5 5 2 2 5 5 5 5 5 5 5 5 5
5 5 2 2 2 2 2 2 2 2 2 2 2 2 2 2 2 2 5 5
5 5 2 5 5 5 5 5 5 5 5 5 5 5 5 5 5 2 5 5
5 5 2 5 2 2 2 5 2 2 2 2 2 2 2 2 2 2 5 5
5 5 2 5 2 2 2 2 2 2 2 2 2 2 2 2 5 5 5 5
5 5 2 5 2 2 2 5 2 2 2 2 2 2 2 5 5 5 5 5
5 5 2 5 5 5 5 5 5 5 5 5 5 5 5 5 5 5 5 5
11 5 2 5 5 5 5 5 5 5 5 5 5 5 5 5 11 11 11 11
11 2 2 2 2 2 2 2 2 2 2 2 2 2 2 2 11 11 11 11
11 11 11 11 11 11 11 11 11 11 11 11 11 11 11 2 11 11 11 11
11 11 11 2 11 11 11 11 11 11 11 11 11 11 11 2 11 11 11 11
11 11 11 2 11 11 11 11 2 2 2 2 2 2 2 2 11 11 11 11
11 11 11 2 11 11 11 11 2 11 11 11 11 11 11 11 11 11 11 11
11 11 11 2 2 2 2 2 2 2 11 11 11 11 7 7 7 7 7 7
11 11 11 11 2 11 11 2 2 2 11 11 11 11 7 2 2 2 2 7
11 11 11 11 2 11 11 2 2 2 11 11 11 11 7 2 2 2 2 7
11 2 11 11 2 11 11 2 2 2 11 11 11 11 7 7 7 7 2 7
11 2 2 11 2 11 11 2 2 2 2 2 2 2 2 2 2 2 2 7
11 2 2 2 2 11 11 2 2 2 11 11 11 11 7 7 7 7 2 7
11 11 11 11 11 11 11 11 2 11 11 11 11 11 7 2 2 2 2 7
4 4 4 4 4 4 4 4 2 4 4 11 11 11 7 2 2 2 2 7
4 1 1 1 1 1 1 2 2 2 4 1 11 11 7 7 7 7 7 7
4 1 1 1 1 1 1 1 1 1 4 1 1 11 11 11 11 11 11 11
4 1 1 1 7 7 7 7 1 1 4 1 1 1 11 11 11 11 11 11
4 1 1 1 7 1 1 1 1 1 4 1 1 1 1 1 1 1 11 11
4 1 1 1 7 7 7 7 1 1 4 1 1 1 11 11 11 1 11 11
4 1 1 1 1 1 1 1 1 1 4 1 1 11 11 11 11 1 11 11
4 4 1 1 4 4 4 4 4 4 4 1 11 11 11 11 11 1 11 11
11 11 1 1 11 11 11 11 11 11 11 11 11 11 1 1 1 1 11 11
11 11 1 1 1 1 1 1 1 1 1 11 11 11 1 1 11 11 11 11
11 11 1 1 1 1 1 1 1 1 1 11 11 11 1 1 11 11 11 11
11 11 1 11 11 11 11 11 11 1 1 11 11 11 1 1 11 11 11 11
11 11 1 11 11 11 11 11 11 1 1 11 11 11 1 1 11 11 11 11
11 11 1 11 11 1 1 1 11 1 1 1 1 1 1 1 11 11 11 11
11 11 1 11 11 11 1 11 11 1 1 1 1 1 1 1 11 11 11 11
11 11 1 1 1 1 1 11 11 1 1 11 11 11 11 11 11 11 11 11
11 11 1 1 1 1 1 11 11 1 1 11 11 11 11 11 11 11 11 11
4 4 4 4 4 4 4 4 4 1 1 4 4 4 4 4 4 4 4 4
4 1 1 1 1 1 1 1 1 1 1 1 4 1 1 1 1 1 1 4
4 1 1 1 1 1 1 1 1 1 1 1 4 1 1 4 1 1 1 4
4 1 1 1 1 1 1 1 1 1 1 1 4 1 1 4 1 1 1 4
4 4 1 4 4 1 1 1 1 1 1 1 4 1 1 4 13 1 13 4
4 1 1 1 4 1 1 1 1 1 1 1 4 1 1 4 1 1 1 4
4 1 1 1 4 1 1 1 1 1 1 1 1 1 1 4 13 1 13 4
4 4 4 4 4 4 4 4 4 4 4 4 4 4 4 4 4 4 4 4